374,375,376,377,378,379,375,376,377,378,379,375,376,377,378,379,375,376,377,378,379,375,376,377,378,379,375,376,377,378,379,375,376,377,378,379,375,376,377,378,379,375,376,377,378,379,375,376,377,378,379,375,376,377,375,376,377,378,379,380
406,429,430,431,432,428,429,430,431,432,428,429,430,431,432,428,429,430,431,432,428,429,430,431,432,428,429,430,431,432,428,429,430,431,432,428,429,430,431,432,428,429,430,431,432,428,429,430,431,432,428,429,430,431,432,428,429,430,431,414
438,461,462,463,464,460,461,462,463,486,460,461,486,463,464,486,461,486,463,464,486,461,462,463,464,460,461,462,463,464,460,461,462,463,464,460,461,462,463,464,460,461,462,463,464,460,461,462,463,464,460,461,462,463,464,460,461,462,463,446
470,493,494,495,496,492,493,494,452,453,454,452,453,454,452,453,454,454,452,453,452,453,494,495,496,492,493,494,495,496,492,493,494,495,496,492,493,494,495,496,396,397,398,495,452,453,454,494,495,496,492,493,494,495,496,492,452,453,454,478
502,525,526,527,528,524,525,526,484,485,486,484,485,486,484,485,486,486,484,485,484,485,486,527,528,524,525,526,527,528,524,525,526,527,528,524,525,526,527,528,428,429,430,527,484,485,486,526,527,528,524,525,526,527,528,524,484,485,486,510
534,397,398,399,400,396,397,486,516,517,518,516,517,518,516,517,518,518,516,517,452,453,398,399,400,396,397,398,399,400,396,397,398,399,400,396,397,398,399,400,460,461,462,399,516,517,518,398,399,400,396,397,398,399,400,396,516,517,518,542
406,429,430,431,432,428,429,430,452,453,454,429,430,431,486,428,429,430,397,452,453,485,486,431,432,428,452,453,454,432,428,452,453,454,453,428,429,452,453,454,428,429,430,431,432,428,429,452,453,454,452,453,454,452,453,454,429,430,431,414
438,461,462,463,464,460,461,462,484,485,486,461,397,398,399,460,461,462,429,484,485,453,462,463,464,460,484,485,486,452,453,454,485,486,452,453,454,484,485,486,460,461,462,463,464,460,461,484,485,486,484,485,486,484,485,486,461,462,463,446
470,493,494,495,496,492,493,486,516,517,518,493,429,452,453,452,453,399,429,452,453,485,494,495,496,492,516,517,518,484,485,486,517,518,484,485,486,516,517,518,492,493,494,495,496,492,493,516,517,518,516,517,518,516,517,518,493,494,495,478
502,525,526,527,528,524,525,526,452,453,454,525,397,484,485,484,485,453,453,452,453,453,526,396,397,398,525,526,452,516,517,518,452,453,516,517,518,454,527,528,396,397,398,527,528,524,525,452,453,454,452,453,454,452,453,454,525,526,527,510
534,397,398,399,400,396,397,398,484,485,486,397,429,484,485,485,484,485,485,484,485,485,398,428,429,430,397,398,484,485,486,486,484,485,486,484,485,486,399,400,428,429,430,399,400,396,397,484,485,486,484,485,486,484,485,486,397,398,399,542
406,429,430,431,432,428,429,430,516,517,518,429,430,452,452,453,485,485,485,452,453,453,430,460,461,462,429,430,516,452,453,454,516,517,452,453,454,518,431,432,460,461,462,431,432,428,429,516,517,518,516,517,518,516,517,518,429,430,431,414
438,461,462,463,464,460,461,462,452,453,454,461,462,452,452,453,452,453,453,453,485,453,462,463,464,460,452,453,454,452,453,454,452,453,484,485,486,452,453,454,460,461,462,463,464,460,461,452,453,454,452,453,454,452,453,454,461,462,463,446
470,493,494,495,496,492,493,494,484,485,486,493,494,484,484,485,484,485,485,485,485,485,494,495,496,492,484,485,486,484,485,486,484,485,516,517,518,484,485,486,492,493,494,495,496,492,493,484,485,486,484,485,486,484,485,486,493,494,495,478
502,525,526,527,528,524,525,526,516,517,518,525,526,527,528,524,525,526,527,528,524,525,526,527,528,524,516,517,518,516,517,518,516,517,484,485,486,516,517,518,524,525,526,527,528,524,525,516,517,518,516,517,518,516,517,518,525,526,527,510
452,453,454,452,453,454,452,453,454,452,453,454,452,453,454,452,453,454,452,453,454,454,452,453,454,452,453,454,454,452,453,454,452,453,516,517,518,454,452,453,454,452,453,454,452,453,454,452,453,454,452,453,454,452,453,454,397,398,399,542
484,485,486,484,485,486,484,485,486,484,485,486,484,485,486,484,485,486,484,485,486,486,484,485,486,484,485,486,486,484,485,486,484,485,486,484,485,486,484,485,486,484,485,486,484,485,486,484,485,486,484,485,486,484,485,486,429,430,431,414
516,517,518,516,517,518,516,517,518,516,517,518,516,517,518,516,517,518,516,517,518,518,516,517,518,516,517,518,518,516,517,518,516,517,518,516,517,518,516,517,518,516,517,518,516,517,518,516,517,518,516,517,518,516,517,518,461,462,463,446
470,493,494,495,452,453,454,494,495,496,492,493,494,495,496,492,493,452,453,454,452,453,454,495,496,492,493,494,495,496,492,493,494,495,496,492,493,494,495,496,492,493,494,495,496,492,493,452,453,454,452,453,454,452,453,454,493,494,495,478
502,525,526,527,484,485,486,526,527,528,524,525,526,527,528,524,525,484,485,486,484,485,486,527,528,524,525,526,527,528,524,525,526,527,528,524,525,526,527,528,524,525,526,527,528,524,525,484,485,486,484,485,486,484,485,486,525,526,527,510
534,397,398,452,453,454,453,454,399,400,396,397,398,399,400,396,397,452,453,454,516,517,518,452,453,454,452,453,454,400,396,397,398,399,400,396,397,398,399,400,396,397,398,399,400,396,397,516,517,518,516,517,518,516,517,518,397,398,399,542
406,429,430,484,485,486,485,486,431,432,428,429,430,431,432,428,429,484,485,486,484,485,486,484,485,486,484,485,486,432,428,429,430,431,432,428,429,430,431,432,428,429,430,431,432,428,429,452,453,454,452,453,454,452,453,454,429,430,431,414
438,461,462,516,517,518,517,518,463,464,460,461,462,463,464,460,461,516,517,518,516,517,518,516,517,518,516,517,518,464,460,461,462,463,464,460,461,462,463,464,460,461,462,463,464,460,461,484,485,486,484,485,486,484,485,486,461,462,463,446
470,493,494,495,516,517,518,494,495,496,492,493,494,495,496,492,493,452,453,454,452,453,454,452,453,454,452,453,454,496,492,493,494,495,496,492,493,494,495,496,492,493,494,495,496,492,493,516,517,518,516,517,518,516,517,518,493,494,495,478
502,525,452,453,452,453,454,453,454,528,524,525,526,527,528,524,525,484,485,486,484,485,486,484,485,486,484,485,486,528,524,525,526,527,528,524,525,526,527,528,524,525,526,527,528,524,525,452,453,454,452,453,454,452,453,454,525,526,527,510
534,397,484,485,484,485,486,485,486,400,396,397,398,399,400,396,397,516,517,518,516,517,518,516,517,518,516,517,518,400,396,397,398,399,400,396,397,398,399,400,396,397,398,399,400,396,397,484,485,486,484,485,486,484,485,486,397,398,399,542
406,429,516,517,516,517,518,517,518,432,428,429,430,431,432,428,429,452,453,454,452,453,454,452,453,454,452,453,454,432,428,429,430,431,432,428,429,430,431,432,428,429,430,431,432,428,429,516,517,518,516,517,518,516,517,518,429,430,431,414
438,461,452,453,454,453,452,453,454,464,460,461,462,463,464,460,461,484,485,486,484,485,486,484,485,486,484,485,486,464,460,461,462,463,464,460,461,462,463,464,460,461,462,463,452,453,454,462,463,464,460,461,462,463,464,460,452,453,454,446
406,493,484,485,486,485,484,485,486,496,492,493,494,495,496,492,493,516,517,518,516,517,518,516,517,518,516,517,518,496,492,493,494,495,496,492,493,494,495,496,492,493,494,495,484,485,486,494,495,496,492,493,494,495,496,492,484,485,486,414
438,525,516,517,452,453,454,517,518,528,524,525,526,527,528,524,525,526,527,528,524,525,526,527,528,524,525,526,527,528,524,525,526,527,528,524,525,526,527,528,524,525,526,527,516,517,518,526,527,528,524,525,526,527,528,524,516,517,518,446
470,397,484,485,484,485,486,485,486,400,396,397,398,399,400,396,397,398,399,400,396,397,398,399,400,396,397,398,399,400,396,397,398,399,400,396,397,398,399,400,396,397,398,399,400,396,397,398,399,400,396,397,398,399,400,396,397,398,399,478
502,429,516,517,516,517,518,517,518,432,428,429,430,431,432,428,429,430,431,432,428,429,430,431,432,428,429,430,431,432,428,429,430,431,432,428,429,430,431,432,428,429,430,431,432,428,429,430,431,432,428,429,430,431,432,428,429,430,431,510
534,461,462,463,464,460,461,462,463,464,460,461,462,463,464,460,461,462,463,464,460,461,462,463,464,460,461,462,463,464,460,461,462,463,464,460,461,462,463,464,460,461,462,463,464,460,461,462,463,464,460,461,462,463,464,460,461,462,463,542
630,631,632,633,634,631,632,633,634,631,632,633,634,631,632,633,634,631,632,633,634,631,632,633,634,631,632,633,634,631,632,633,634,631,632,633,634,631,632,633,634,631,631,632,633,634,631,632,633,634,631,632,633,634,631,632,633,634,635,636
